#################################################|#
#*                # #*                            #
#            *#   # # ########### ### ########### #
#*            #^^^# # #     #     #   #       # # #
#            *#   # ### ###^# ####### ##### # # # #
#*            #^^^#   # #   #       # #   # # # # #
#            *#   # ### # ### ##### ### # # # # # #
#*            #   #   # # #       # #   #^  # # # #
#            *#   ### # # ######### # ####### # # #
# #############^^^# # # #          *#     # # # # #
# |||##||##||##   # # # ####### ######### # # ### #
#    ##      ##   #  ^#     # # #   #       #   # #
##    #      ##^^^# ##### # # # # # # ######### # #
##   ##  ##  ##   # # # # # #   # #     #     # # #
#    ##  ##  ##^^^# # # # # ##### ####### ### # # #
##   ##  ##   #^^^#^  # # #       #     # #   # # #
##    #  ##  ##   ##### # ######### ### # # ### # #
##   ##  ##  ##   #     # #       # #   # #   # # #
##   ##  ##  ##   # ##### # #####^# # ### ##### # #
#    ##  #   ##^^^# #     #   #   # #     #   # # #
##   ##  ##  ##   # ######### # ### ####### # # # #
##   ##  ##  ##^^^# #         #   #   #     # # # #
##       ##   #   # # ########### ### # ##### # # #
##       ##  ##^^^# #   #       #   # #     # # # #
############ ##^^^#####^# ##### ### # # ### ### # #
#            ##         # #   #   #     # #    ^# O
###################################################